11111111111111
1P001111110011
1CCE111111C011
11111111111111