11111111111111
1P001111110011
1CCE1111110011
11111111111111