11111111111111
10101111110011
10010111110011
100001E0000001
1000C000P00001
10C00000000001
100000000C0001
101000C0000011
11111111111111