11111111111111
1P001111110011
1CCE0111110011
11111111111111