111111111111111111
100E00000000000001
100000C00C000000P1
111111111111111111
