111111111111111111
111E01000000001001
11001P100C00001C01
111111111111111111